11111111111111111111
11181111111222222211
11122222222221122111
11111111111111112111
11122222111112222111
11172212222222111111
11111221111112111111
11111122311223111111
11117221122213311111
11111144111111441111
;