11111111111111111111
11111121117822211111
11111122222211211111
11111112211112211111
11111227111111221111
11322211111111121111
11111211111132221111
11111222222231111111
11111111111221111111
11111111111411111111
;