11111111111111111111
11111111111111111111
11221111112222311111
11123211112112211111
11111222282111221111
11111221111111121111
11117211111111122111
11112211111112221111
11723212222222111111
11441111111411111111
;