1111111111111111111111111111111111111111111111111
1821111111111111111111111111111111111111111111111
1121111112222222221111111111111111111111111111111
1122222222222111122222222222222222222222222227111
1111111111111111111122111111111122211111111122211
1111111111111222222222111111111112221111111111111
1111111112222221112221111111111111221111111111111
1111111111122111111332222211111111122111111111111
1222222222222111111111111111111111122211111111111
1111222211111111111111111111111111111232221111111
1111111222223111111111111111111111111221111111111
1111111111221111111111111111111112222211111111111
1111111111223211111111111112232272111111111111111
1111111111222111111111111111112232211111111111111
1111112322211111111111111111111112211111111111111
1111111221111111111111111111111112211111111111111
1111111221111111111111111111112322231111111111111
1112232211111111111111111111122221111111111111111
1111122111111111111111111111111221111111111111111
1111132222111111111111111122222211111111111111111
1111111132111111111111111111221111111111111111111
1111111112223111111111112322211111111111111111111
1111111111122111111111111221111111111111111111111
1111111111112211111111111122231111111111111111111
1111111111111331111111111122222232111111111111111
1111111111111441111111111111114111111111111111111
;