1111111111111111111111111111111111111111111111111
1811111111111111111111111111111111111111111111111
1221111111111111111111111111111111111111111111111
1122222222222222222222222222222222222222111111111
1111111121111111111111111111111111111122111111111
1111111121111111111111111111111111112221111111111
1111111122211111111111111111111172222211111111111
1111111123311111111111111111111122111111111111111
1111113221111111111111111111133322232221111111111
1111111221112222222222222222222222111111111111111
1111111221112211111111111111111112211111111111111
1322222221222111111111111111111111222111111111111
1112117222211111111111111111111111112211111111111
1322111111111111111111111111132222222222222111111
1112211111111111111111111111112211111111111111111
1222111111111111111111132222222111111111111111111
1122111111111111111222222111111111111111111111111
1112211111111111122211111111111111111111111111111
1111222311111111111222111111111111111111111111111
1111122211111111111122222222211111111111111111111
1111112211111111111111111111211111111111111111111
1111112211111111111111111222211111111111111111111
1111222211111111111322222211111111111111111111111
1111221111111111111122111111111111111111111111111
1111121111111111111113111111111111111111111111111
1111141111111111111114441111111111111111111111111
;