1111111111111111111111111111111111111111111111111
1111111111111111111111128111111111111111111111111
1111111111111111111132221111111111111111111111111
1111111111111111111112111111111111111111111111111
1111111111111111111112211111111111111111122222211
1111111111111111111111231111111111111111122112211
1111111111232222222222222222222111111111122212211
1111111111112211111111111111112211111111112212211
1111111111222111111111111111111222222211112212211
1111111222231111111111111111111111122111112212211
1111122211111111111111111111113222221111222112211
1111111211111111111111112322222211111111221112211
1111111222111111111111111122111111111222211222211
1111722222111111111111122221111111112211111222111
1111111112222222222222221111111111222113222221111
1111111111112222211111111111112222211111222111111
1111123222222212222222311112222111132222221111111
1111111221111111111132111222111111122111111111111
1111222211111111111112222211111112221111111111111
1111112211111111111111111122222222111111111111111
1112222111111111111111111122111111111111111111111
1111221111111111111111111112211111111111111111111
1222221111111111111111111111211111111111111111111
1112231111111111111111111111222311111111111111111
1111127111111111111111111111112111111111111111111
1111141111111111111111111111114111111111111111111
;